1,3,6,9,2
2,3,6,9,2
3,4,4,8,2
4,3,6,9,2
5,3,4,6,2
