1,3,6,9,2
2,3,6,9,2
3,8,5,8,2
4,3,6,9,2
5,3,4,6,2
